2 2 
2 2 2 2 2 2 2 2 2 2 2 2 2 2 2 2
2 11 2 3 3 2 3 2 2 3 2 3 3 2 15 2
2 3 2 3 3 3 3 3 3 3 3 3 3 2 3 2
2 3 2 2 3 2 3 2 2 3 2 3 2 2 3 2
2 3 3 3 3 2 4 2 2 4 2 3 3 3 3 2
2 3 2 3 3 3 3 2 2 3 3 3 3 2 3 2
2 3 3 3 3 2 4 2 2 4 2 3 3 3 3 2
2 3 3 2 3 2 3 2 2 3 2 3 2 2 3 2
2 2 2 2 3 3 3 3 3 3 3 3 2 2 3 2
2 12 3 3 3 3 2 3 3 2 3 3 3 2 13 2
2 2 2 2 2 2 2 2 2 2 2 2 2 2 2 2