1 1 
1  1  1  1  1  1  1  1  1  1  1  1  1  1  1  1
1  3  3  3  3  1  3  3  1  3  3  3  3  3 12  1
1  3  4  1  3  1  3  3  1  3  1  1  3  1  1  1
1  3  3  3  3  1  3  3  1  3  3  3  3  3 13  1
1  3  4  1  3  1  3  3  3  3  3  1  3  1  1  1
1  3  3  3  4  3  3  3  1  1  3  3  3  3 14  1
1  3  4  1  3  1  3  3  3  3  3  1  3  1  1  1
1  3  3  3  3  1  3  3  1  3  3  3  3  3 15  1
1  3  4  1  3  1  3  3  1  3  1  1  3  1  1  1
1  3  3  3  3  1  3  3  1  3  3  3  3  3 16  1
1  1  1  1  1  1  1  1  1  1  1  1  1  1  1  1