1 1 
0  0  0  0  0  0  0  0  0  0  0  0  0  0  0  0
0  3  3  3  3  3  3  3  3  3  3  3  3  3  3  0
0  3  4  3  3  3  3  3  3  3  3  3  3  4  3  0
0  3  3  3  3  3  11 0  0 12  3  3  3  3  3  0
0  3  3  3  3  3  0  0  0  0  3  3  3  3  3  0
0  3  4  3  3  3  13 0  0 14  3  3  3  4  3  0
0  3  3  3  3  3  0  0  0  0  3  3  3  3  3  0
0  3  3  3  3  3  15 0  0 16  3  3  3  3  3  0
0  3  4  3  3  3  3  3  3  3  3  3  3  4  3  0
0  3  3  3  3  3  3  3  3  3  3  3  3  3  3  0
0  0  0  0  0  0  0  0  0  0  0  0  0  0  0  0